###############
#....*....*...#
#..^..#..&..*.#
###.....###...#
#...&...~....*#
#.###.....###.#
#..*..^..&....#
#....*....*...#
###############
