###############
#....*....*...#
#..^..#..&....#
#....~.....^..#
#.*....*......#
###############
